0,3,0,0,0,0,0,0,0,0,0,0,0,0,0,0,0,0,0,0,0,0,0,0,0,0,0,0,0,0
0,1,0,0,0,0,0,0,0,0,0,0,0,0,2,1,1,6,0,0,0,0,0,0,0,0,0,0,0,0
0,1,0,0,0,2,1,5,0,0,0,0,0,0,1,0,0,1,1,5,0,0,0,0,0,0,0,0,0,0
0,1,0,0,0,1,0,0,0,0,0,0,0,5,1,0,0,1,0,0,0,0,0,0,0,0,0,0,0,0
0,2,1,1,1,1,0,0,0,0,0,0,0,0,1,0,0,1,0,0,5,0,0,0,0,0,0,0,0,0
0,1,0,0,0,2,1,1,1,1,1,1,1,1,6,0,0,1,0,0,1,0,0,0,0,0,0,0,5,0
0,1,0,0,0,1,5,0,5,0,1,0,0,0,2,5,0,2,1,1,1,1,1,1,6,0,0,0,1,0
0,1,0,0,0,1,0,0,0,0,1,0,0,0,0,0,0,0,0,0,0,5,0,5,1,0,0,0,1,0
0,5,0,0,0,5,0,0,0,0,5,0,0,0,0,0,0,0,0,0,0,0,0,0,1,5,0,0,1,0
0,0,0,0,0,0,0,0,0,0,0,0,0,0,0,0,0,0,0,0,0,0,0,0,2,1,1,1,1,4
